RCCCCCCCCR
CCCCCCCCCC
CCCCCCCCCC
CCCCCCCCCC
CCCCDDCCCC
CCCCCCCCCC
CCCCCCCCCC
CCCCCCCCCC
RCCCCCCCCR