RCCCCCCDWRCCCCCCCC
CCCCCCCCWCCCCCCCCC
CCCCCCCCWCCCCCCCCC
CCCCCCCCWDCCCCCCCC
CCCCCCCCCCCCCCCCCC
CCCCCCCDWCCCCCCCCC
CCCCCCCCWCCCCCCCCC
CCCCCCCCWCCCCCCCCC
CCCCCCCRWDCCCCCCCR