RCCCCCCCCW
WWWWWWWWCW
WCCCCCCWCW
WCWWWWCWCW
WCWCTWCWCW
WCWCWWCWCW
WCWCCCCWCW
WCWWWWWWCW
WCCCCCCCCW
WWWWWWWWWW