DDDDDDDDDDDDDDDDDD
WWWWWWWWWWWWWWWWWD
DDDDDDDDDDDDDDDDDD
DDDDDDDDDDDDDDDDDD
DDDDRDDDDDDDDRDDDD
DDDDDDDDDDDDDDDDDD
DDDDDDDDDDDDDDDDDD
DDDDDDDDDDDDDDDDDD
DDDWWWWWWWWWWWWDDD
DDDDDDDDDDDDDDDDDD
DDDDDDDWDDDDDDDDDD
DDDDDDDWDDDDDDDDDD
DDDDDDDWDDDDDDDDDD
DDDDRDDWDDDDDRDDDD
DDDDDDDDDDDDDDDDDD
DDDDDDDDDDDDDDDDDD
DDDDDDDDDDDDDDDDDD
DDDDDDDDDDDDDDDDDD