CCCCCCCCCC
CCCCCDCCCC
RCCDCCCCCC
CCCCCCCCCC
CCCDCCDCCC
CCCCCCCCCC
CCCCCCCCCC
CCCCCCCCCC
CCCCCCCCCC
CCCCCCCCCC