DDDDDDDDWDDDDDDDDD
DDDDDDDDWDDDDDDDDD
DDDDDDDDWDDDDDDDDD
DDDDDDDDWDDDDDDDDD
DDDDRDDDDDDDDRDDDD
DDDDDDDDWDDDDDDDDD
DDDDDDDDWDDDDDDDDD
DDDDDDDDWDDDDDDDDD
WWWWWWWWWWWWWWWWWW
DDDDDDDDDDDDDDDDDD
DDDDDDDDDDDDDDDDDD
DDDDDDDDDDDDDDDDDD
DDDDDDDDDDDDDDDDDD
DDDDRDDDDDDDDRDDDD
DDDDDDDDDDDDDDDDDD
DDDDDDDDDDDDDDDDDD
DDDDDDDDDDDDDDDDDD
DDDDDDDDDDDDDDDDDD